0000000000
0000000000
0000000000
1000000001
1111100001
1000000001
1111110001
1001000101
1000001101
1111111001
