111111111111111111111111111111111111111111111111111111111111
111111111111111111111111111111111111111111111111111111111111
111111111111111111111111111111111111111111111111111111111111
111111111111111111111111111111111111111111111111111111111111
111111111111111111111111111111111111111111111111111111111111
11111T000000000000000000000T11T00000000000000000000000T11111
111111111111111111100111111111111111100011000111111100011111
111111111111111111100111111111110000000011000111111100011111
1111111111100000000000000011000001110011110T0111111100011111
1111100000000111111111110000001111110011100000000000T0011111
11111T1111110111111111110T1100111110001111111100111001111111
111110111111011111111111111100111110001111111100111001111111
111110000T000111111111T0000000000000000000000000000000111111
111110000000011111111100000000000000000000000000000000111111
111111111011111111111100000000000000000000000000000000111111
1111111110111111111111000000000000000000T0000000000000111111
1111111110111111111111000000000T0000000000000000000000111111
111111111011111111111100000000000000000000000000000000111111
1111111110111111111111000000000000000000000T0000000000111111
111110000000000000001100000000000000000000000000000000111111
111110000000000000001100000000000000000000000000000000111111
11111000000000000000T1T0000000000000000000000000000000111111
1111101111111111111111000000000000000T0000000000000000111111
11111T1111111111T000000000000000000000000000000000000T111111
111110111111111111111111111000111111100011111110001111111111
111110000000011111111111111001111111100011111111001111111111
111111111111111111111111110001111111100011111111000111111111
111111111111111111111111110011111111101011111111100111111111
111110000000000000000000000011111111101011111000000011111111
11111T000000000000000000000011111111001001111111110011111111
111110000011111111000000000111111100001000001111110001111111
11111100011T001100000000111100000000001000000T11100000011111
1111110001111011110001111111001111111111000001T1111100111111
111111000000001111000000T11100000T1000T000000101111100111111
1111111111111T111111000001111111111111111111000000T100111111
111111111111101111110000000000000000000000000000000000111111
11111111111110000000000000000000T000000000000000000000111111
111111111111100000000000000000000000000000000000000000111111
111111111111100000000000000000000000000000000000000000111111
1111111111111111111111111111111111111111111111111111T1111111
111111111111111111111111111111111111111111111111111111111111
111111111111111111111111111111111111111111111111111111111111
111111111111111111111111111111111111111111111111111111111111
111111111111111111111111111111111111111111111111111111111111
111111111111111111111111111111111111111111111111111111111111
